#######
#..#..#
#.....#
#.....#
#..C..#
#.....#
##....#
#.....#
#....##
#.....#
#.....#
#.....#
#.....#
#.P...#
#######
